I=Io
You=Tu
He=Lui
She=Lei
We=Noi
They=Loro
Man=Uomo
Woman=Donna
Child=Bambino
Family=Famiglia
Mother=Madre
Father=Padre
Brother=Fratello
Sister=Sorella
Friend=Amico
To be=Essere
To have=Avere
To do=Fare
To go=Andare
To come=Venire
To eat=Mangiare
To drink=Bere
To speak=Parlare
To know(fact)=Sapere
To know(person)=Conoscere
To want=Volere
To like=Piacere
To see=Vedere
To say=Dire
To work=Lavorare
To give=Dare
To take=Prendere
To live=Vivere
To wait=Aspettare
House=Casa
Car=Macchina
City=Città
Book=Libro
Water=Acqua
Food=Cibo
Day=Giorno
Night=Notte
Time=Tempo
Money=Soldi
Sun=Sole
Moon=Luna
Table=Tavolo
Chair=Sedia
Door=Porta
Window=Finestra
Street=Strada
Big=Grande
Small=Piccolo
Good=Buono
Bad=Cattivo
Happy=Felice
Sad=Triste
Hot=Caldo
Cold=Freddo
New=Nuovo
Old=Vecchio
Beautiful=Bello
Easy=Facile
Difficult=Difficile
In=In
On=Su
Under=Sotto
With=Con
Of=Di
For=Per
From=Da
One=Uno
Two=Due
Three=Tre
Four=Quattro
Five=Cinque
Six=Sei
Seven=Sette
Eight=Otto
Nine=Nove
Ten=Dieci
Hundred=Cento
Yes=Sì
No=No
Please=Per favore
Thank you=Grazie
Hello=Ciao
Goodbye=Arrivederci
Excuse me=Scusi
Today=Oggi
Tomorrow=Domani
Yesterday=Ieri
Now=Adesso
Then=Poi
Also=Anche
But=Ma
And=E
Or=O
Very=Molto
Here=Qui
There=Lì
study=Studiare
work=Lavorare
understand=Capire
call=Chiamare
wait=Aspettare
travel=Viaggiare
buy=Comprare
sell=Vendire
open=Aprire
close=Chiudere
listen=Ascoltare
watch/look=Guardare
hear/feel=Sentire
sleep=Dormire
wake up=Svegliarsi
sit=Sedere
stand up/get up=Alzarsi
finish=Finire
start=Iniziare
read=Leggere
write=Scrivere
teach=Insegnare
learn=Imparare
Telephone=Telefono
Computer=Computer
Newspaper=Giornale
Letter=Lettera
Gift=Regalo
Coffee=Caffè
Tea=Tè
Breakfast=Colazione
Lunch=Pranzo
Dinner=Cena
Dress/Clothes=Vestito
Shoes=Scarpe
Sky=Cielo
Earth/Land=Terra
Air=Aria
River=Fiume
Mountain=Montagna
Sea=Mare
Beach=Spiaggia
Tree=Albero
Flower=Fiore
Animal=Animale
Cat=Gatto
Dog=Cane
Bird=Uccello
Fish=Pesce
Late=Tardi
Early=Presto
Open=Aperto
Closed=Chiuso
Long=Lungo
Short=Corto
Tall/High=Alto
Short/Low=Basso
Fast=Veloce
Slow=Lento
Strong/Loud=Forte
Weak=Debole
True=Vero
False=Falso
Important=Importante
Interesting=Interessante
Necessary=Necessario
Possibile=Possibile
Immediately=Subito
Always=Sempre
Never=Mai
Often=Spesso
Rarely=Raramente
Still/Yet=Ancora
Already=Già
Without=Senza
After=Dopo
Before=Prima
Between/Among=Tra
Towards=Verso
That=Quello
This=Questo
Where=Dove
When=Quando
Why=Perché
How=Come
Which=Quale
How much=Quanto
Blue (light)=Azzurro
Red=Rosso
Green=Verde
Yellow=Giallo
Black=Nero
White=Bianco
Gray=Grigio
Purple=Viola
Brown=Marrone
Today=Oggi
Tomorrow=Domani
Yesterday=Ieri
Week=Settimana
Month=Mese
Year=Anno
Head=Testa
Hand=Mano
Foot=Piede
Eye=Occhio
Ear=Orecchio
Mouth=Bocca
Nose=Naso
Arm=Braccio
Leg=Gamba
Heart=Cuore
Feeling/Sentiment=Sentimento
Emotion=Emozione
Love=Amore
Hate=Odio
Fear=Paura
Courage=Coraggio
Hope=Speranza
Anger=Rabbia
Joy=Gioia
Sadness=Tristezza
Healthy=Sano
Sick=Malato
Tired=Stanco
Hungry=Affamato
Thirsty=Assetato
Rich=Ricco
Poor=Povero
Clean=Pulito
Dirty=Sporco
Wine=Vino
Beer=Birra
Sugar=Zucchero
Salt=Sale
Butter=Burro
Cheese=Formaggio
Bread=Pane
Fruit=Frutta
Vegetable=Verdura
Oil=Olio
Light=Luce
Shadow=Ombra
Noise=Rumore
Silence=Silenzio
Wind=Vento
Rain=Pioggia
Snow=Neve
Weather=Tempo
North=Nord
South=Sud
East=Est
West=Ovest
Right=Destra
Left=Sinistra
Straight=Diritto
Behind=Dietro
In front of=Davanti
Near=Vicino
Far=Lontano
Inside=Dentro
Outside=Fuori
Above=Sopra
Below=Sotto
Pass=Passare
Find=Trovare
Lose=Perdere
Bring/Carry=Portare
Put=Mettere
Show=Mostrare
Change=Cambiare
Use=Usare
Help=Aiutare
Meet=Incontrare
Remember=Ricordare
Forget=Dimenticare
Explain=Spiegare
Decide=Decidere
Believe=Credere
Search/Look for=Cercare
Buy=Comprare
Play=Giocare
Sing=Cantare
Dance=Ballare
Paint=Dipingere
Draw=Disegnare
Dream=Sognare
Work=Lavorare
Drive=Guidare
Fly=Volare
Swim=Nuotare
Body=Corpo
Culture=Cultura
History=Storia
Art=Arte
Science=Scienza
Language=Lingua
Problem=Problema
Solution=Soluzione
Question=Domanda
Answer=Risposta